{
  "name": "Meadow",
  "gridWidth": 23,
  "gridHeight": 20,
  "tileKey": {
    "0": "ground",
    "1": "path",
    "2": "water",
    "3": "obstacle",
    "4": "spawn",
    "5": "goal"
  },
  "background": "ToolPack/map/background.png",
  "tilePixelSize": 64,
  "tiles": [
    [3,3,3,3,3,3,3,3,3,3,3,3,3,3,3,3,3,3,3,3,3,3,3],
    [3,3,3,3,3,3,3,3,3,3,3,3,3,3,3,3,3,3,3,3,3,3,3],
    [3,3,3,3,3,3,3,3,3,3,3,3,3,3,3,3,3,3,3,3,3,3,3],
    [0,0,0,0,0,0,0,0,0,0,0,0,0,0,0,0,0,0,0,0,0,0,0],
    [0,0,0,0,0,0,0,0,0,0,0,0,0,0,0,0,0,0,0,0,0,0,0],
    [0,0,0,0,0,0,0,0,0,0,0,0,0,0,0,0,0,0,0,0,0,0,0],
    [0,0,0,0,0,0,0,0,0,0,0,0,0,0,0,0,0,0,0,0,0,0,0],
    [0,0,0,0,0,0,0,0,0,0,0,0,0,0,0,0,0,0,0,0,0,0,0],
    [0,0,0,0,1,1,1,1,1,1,1,1,1,1,0,0,0,0,0,0,0,0,0],
    [0,0,0,0,1,1,1,1,1,1,1,1,1,1,0,0,0,0,0,0,0,0,0],
    [0,0,0,0,1,1,0,0,0,0,0,0,1,1,0,0,0,0,0,0,0,0,0],
    [0,0,0,0,1,1,0,0,0,0,0,0,1,1,0,0,0,0,0,0,0,0,0],
    [4,1,1,1,1,1,0,0,0,0,0,0,1,1,0,0,0,0,0,0,0,0,0],
    [4,1,1,1,1,1,0,0,0,0,0,0,1,1,0,0,0,0,0,0,0,0,0],
    [0,0,0,0,0,0,0,0,0,0,0,0,1,1,0,0,0,0,0,0,0,0,0],
    [0,0,0,0,0,0,0,0,0,0,0,0,1,1,0,0,0,0,0,0,0,0,0],
    [0,0,0,0,0,0,0,0,0,0,0,0,1,1,1,1,1,1,1,1,1,1,5],
    [0,0,0,0,0,0,0,0,0,0,0,0,1,1,1,1,1,1,1,1,1,1,5],
    [0,0,0,0,0,0,0,0,0,0,0,0,0,0,0,0,0,0,0,0,0,0,0],
    [0,0,0,0,0,0,0,0,0,0,0,0,0,0,0,0,0,0,0,0,0,0,0]
  ],
  "paths": [
    {
      "spawnWeight": 1,
      "waypoints": [[-0.5, 12.5], [4.5, 12.5], [4.5, 8.5], [12.5, 8.5], [12.5, 16.5], [22.5, 16.5]]
    }
  ],
  "startingLives": 10,
  "startingCoins": 60,
  "totalWaves": 20,
  "enemyScaling": {
    "baseEnemyHealth": 30,
    "healthPerWave": 15,
    "baseEnemyCount": 5,
    "enemiesPerWave": 1.5,
    "baseEnemySpeed": 2
  },
  "economy": {
    "baseCoinsPerKill": 1,
    "waveCompletionBonus": 10
  },
  "quiz": {
    "questionsPerWave": 2,
    "coinsPerCorrectAnswer": 5
  }
}
